###############
#C#C..........#
#.###########.#
#.#....C......#
#...#.#####...#
###.#....C#.###
#.E.#######...#
#......P......#
#####.###.#####
#C#.....#..C..#
#.#####.#####.#
#.#C#.........#
#.#.#.#.#######
#.....#......C#
###############